{
    "mapData": [
      [0, 0, 0, 0, 0, 0, 2, 0, 3, 0, 0, 0, 0],
      [0, 0, 0, 0, 0, 0, 2, 0, 1, 0, 0, 0, 0],
      [0, 0, 0, 0, 2, 0, 2, 2, 1, 1, 1, 1, 0],
      [0, 0, 0, 0, 0, 0, 2, 0, 0, 0, 2, 1, 0],
      [0, 0, 2, 0, 0, 2, 2, 0, 2, 0, 0, 1, 0],
      [4, 1, 1, 1, 1, 1, 1, 1, 1, 1, 1, 1, 2],
      [0, 0, 0, 2, 0, 0, 2, 1, 0, 2, 0, 1, 0],
      [0, 0, 0, 0, 0, 0, 0, 1, 0, 0, 0, 1, 0],
      [0, 0, 0, 0, 0, 0, 0, 1, 0, 0, 0, 1, 0],
      [0, 0, 0, 0, 0, 0, 0, 3, 0, 0, 0, 3, 0]
    ],
    "monsterPaths": [
      [[8, 0], [8, 1], [8, 2], [9, 2], [10, 2], [11, 2], [11, 3], [11, 4], [11, 5], 
       [10, 5], [9, 5], [8, 5], [7, 5], [6, 5], [5, 5], [4, 5], [3, 5], [2, 5], 
       [1, 5], [0, 5]],
      [[11,9],[11,8],[11,7],[11,6],[11,5], [10, 5], [9, 5], [8, 5], [7, 5], [6, 5], [5, 5], [4, 5], [3, 5], [2, 5], 
      [1, 5], [0, 5]]
    ]
  }
